kobuki instantiated
Loading map
num1: 270, num2: 120, num3: 360
load 480 -240 600 -60
00000000000000000000000000000000000000000000000000000000000000000000000000000000000000000000000000000000|
00000000000000000000000000000000000000000000000000000000000000000000000000000000000000000000000000000000|
00000000000000000000000000000000000000000000000000000000000000000000000000000000000000000000000000000000|
00000000000000000000000000000000000000000000000000000000000000000000000000000000000000000000000000000000|
00000000000000000000000000000000000000000000000000000000000000000000000000000000000000000000000000000000|
00000000000000000000000000000000000000000000000000000000000000000000000000000000000000000000000000000000|
00000000000000000000000000000000000000000000000000000000000000000000000000000000000000000000000000000000|
00000000000000000000000000000000000000000000000000000000000000000000000000000000000000000000000000000000|
00000000000000000000000000000000000000000000000000000000000000000000000000000000000000000000000000000000|
00000000000000000000000000000000000000000000000000000000000000000000000000000000000000000000000000000000|
00000000000000000000000000000000000000000000000000000000000000000000000000000000000000000000000000000000|
00000000000000000000000000000000000000000000000000000000000000000000000000000000000000000000000000000000|
00000000000000000000000000000000000000000000000000000000000000000000000000000000000000000000000000000000|
00000000000000000000000000000000000000000000000000000000000000000000000000000000000000000000000000000000|
00000000000000000000000000000000000000000000000000000000000000000000000000000000000000000000000000000000|
00000000000000000000000000000000000000000000000000000000000000000000000000000000000000000000000000000000|
00000000000000000000000000000000000000000000000000000000000000000000000000000000000000000000000000000000|
00000000000000000000000000000000000000000000000000000000000000000000000000000000000000000000000000000000|
00000000000000000000000000000000000000000000000000000000000000000000000000000000010000000000000000000000|
00000000000000000000000000000000011111111111111111111111101010010000000000000000000000000000000000000000|
00000000000000000000000000000000011111111111111111111111111111111111111111111111110000000000000000000000|
00000000000000000000000000000000011100000000000000000001111111111111111111111111110000000000000000000000|
00000000000000000000000000000000011100000000000000000000000000000000000000000011110000000000000000000000|
00000000000000000000000000000000011100000000000000000000000000000000000000000011110000000000000000000000|
000000000000000000000000000000000111000X0000000000000000000000000000000000000001110000000000000000000000|
00000000000000000000000000000000011100000000000000000000000000000000000000000011110000000000000000000000|
00000000000000000000000000000000011100000000000000000000000000000000000000000001111111100000000000000000|
00000000000000000000000000000000011100000000000000000000000000000000000000000001000011100000000000000000|
00000000000000000000000000000000011100000000000000000000000000000000000000000000000011100000000000000000|
00000000000000000000000000000000011100000000000111111111111111111100000000000000000011100000000000000000|
00000000000000000000000000000001011000000000000011111111011010010000000000000000000011100000000000000000|
00000000000000000000000000000000011000000000000011111111111111111100000000000000000011100000000000000000|
00000000000000000000000011111111011000000000000011111111111111111000000000000000001011110000000000000000|
00000000000000001111111111111111010000000000000011110000000000000000000000000000000011110000000000000000|
00000000000000011111111100000011110000000000000011000000000000000000000000000000000011110000000000000000|
00000000000000011000000000000001111000000000000011000000000000000000000000000000000011100000000000000000|
00000000000000011000000000000001110000000000000011000000000000000000000000000000000011100000000000000000|
00000000000000011100000000000001010000000000000011000000000000000000000000000000000011100000000000000000|
00000000000000011100000000000001110000000000000011000000000000000000000000000000000001100000000000000000|
00000000000000011100000000000001010000000000000011000000000000000000000000000000000001100000000000000000|
00000000000000011100000000000001010000000000000011000000000000000000000000000000000001100000000000000000|
00000000000000011100000000000001010000000000000011000000000011111111010000000000000001100000000000000000|
00000000000000001100000000000001010000000000000011000000000011111111110000000000000001100000000000000000|
00000000000000001100000000000001010000000000000011000000000010000111110000000000000001100000000000000000|
00000000000000011100000000000001011000000000000111000000000000000111010000000000000001100000000000000000|
00000000000000011100000000000001111111111110110111000000000000000001010000000000000001100000000000000000|
00000000000000010100001101000001111111111111111111000010000011111111010000000000000001100000000000000000|
00000000000000000000011101000000000000000000000000000000000011111111010000000000000001100000000000000000|
00000000000000000000011101000000000000000000000000000000000000000000000000000000000001100000000000000000|
00000000000000000000011100000000000000000000000000000000000000000000000000000000000001100000000000000000|
00000000000000000000011100000000000000000000000000000000000000000000000000000000000001100000000000000000|
00000000000000000000001110000000000000000000000000000000000000000000000000000000000001100000000000000000|
00000000000000000000001110000000000000000000000000000000000000000000000000000000000101100000000000000000|
00000000000000000000001110000000000000000000000000000000000000000000000000000000000101100000000000000000|
00000000000000000000001110000000000000000000000000000000000000000000000000000000000101100000000000000000|
00000000000000000000001110000000000000000000000000000000000000000000000000000000000111100000000000000000|
00000000000000000000001110000000000000000000000000000000000000000000000000000000000001100000000000000000|
00000000000000000000001110000000000000000000000000000000000000000000000000000000000001100000000000000000|
00000000000000000000001110000000000000000000000000000000000000000000000111100000000001100000000000000000|
00000000000000000000001110000000000001000000000000000000000000000011111110000000000001100000000000000000|
00000000000000000000001110011111111111111000000000000000000000000011111111101000000001100000000000000000|
00000000000000000000001111111111111111111000000000000000000000000001011100000000000000100000000000000000|
00000000000000000000001111111111111111101000000000000000000000000011000000000000000001100000000000000000|
00000000000000000000001101000000000000000000000000000000000000000001000000000000000000100000000000000000|
00000000000000000000001100000000000000000000000000011101100000111111000000000000000000100000000000000000|
00000000000000000000001100000000000000000000000000011111111111111111100000000000000000100000000000000000|
00000000000000000000001100000000000000000000000000011111111111110111100000000000000000100000000000000000|
00000000000000000000001100000000000000000000000000111000000000000001000000000000000000100000000000000000|
00000000000000000000000100000000000000000000000000111000000000000001000000000000000000100000000000000000|
00000000000000000000000100000000000000000000000000011000000000000001000000000000000000100000000000000000|
00000000000000000000000100000000000000000000000000011000000000000001000000000000000000100000000000000000|
00000000000000000000000100000000000000000000000000001000000000000001100000000000000000100000000000000000|
00000000000000000000000100000000000000000000000000000000000000000001100000000000000000100000000000000000|
00000000000000000000000110000000000000000000000000000100000000000001110000000000000000100000000000000000|
00000000000000000000000110000000000000000000000000000000000000000001110000000000000000100000000000000000|
00000000000000000000000110000000000000000000000000000000000000000001110000000000001111110000000000000000|
00000000000000000000000110000000000000000000000000000000000000000001110000000000001100000000000000000000|
00000000000000000000000110000000000000000000000000000000000000000001110000000000001100000000000000000000|
00000000000000000000000110000000000000000000000000000000000000000001110000000000001100000000000000000000|
00000000000000000000000110000000000000000000000111100000000000000001110000000000001100000000000000000000|
00000000000000000000000110000000000000000000111100000000000000001111110010100000001100000000000000000000|
00000000000000000000000110000000000001101111111111111111111111111111111111111111111100000000000000000000|
00000000000000000000000110111111111111111111111111100000000000000000011000000000000000000000000000000000|
00000000000000000000000011111111111111111100000000000000000000000000000000000000000000000000000000000000|
00000000000000000000000010100000000000000000000000000000000000000000000000000000000000000000000000000000|
00000000000000000000000000000000000000000000000000000000000000000000000000000000000000000000000000000000|
00000000000000000000000000000000000000000000000000000000000000000000000000000000000000000000000000000000|
00000000000000000000000000000000000000000000000000000000000000000000000000000000000000000000000000000000|
00000000000000000000000000000000000000000000000000000000000000000000000000000000000000000000000000000000|
00000000000000000000000000000000000000000000000000000000000000000000000000000000000000000000000000000000|
00000000000000000000000000000000000000000000000000000000000000000000000000000000000000000000000000000000|
00000000000000000000000000000000000000000000000000000000000000000000000000000000000000000000000000000000|
00000000000000000000000000000000000000000000000000000000000000000000000000000000000000000000000000000000|
00000000000000000000000000000000000000000000000000000000000000000000000000000000000000000000000000000000|
00000000000000000000000000000000000000000000000000000000000000000000000000000000000000000000000000000000|
00000000000000000000000000000000000000000000000000000000000000000000000000000000000000000000000000000000|
00000000000000000000000000000000000000000000000000000000000000000000000000000000000000000000000000000000|
00000000000000000000000000000000000000000000000000000000000000000000000000000000000000000000000000000000|
00000000000000000000000000000000000000000000000000000000000000000000000000000000000000000000000000000000|
00000000000000000000000000000000000000000000000000000000000000000000000000000000000000000000000000000000|
00000000000000000000000000000000000000000000000000000000000000000000000000000000000000000000000000000000|
00000000000000000000000000000000000000000000000000000000000000000000000000000000000000000000000000000000|
00000000000000000000000000000000000000000000000000000000000000000000000000000000000000000000000000000000|
00000000000000000000000000000000000000000000000000000000000000000000000000000000000000000000000000000000|
Map loaded
0 10
Point coord0 0 0 0
ind_start_x 24 ind_start_y 39 ind_goal_x 24 ind_goal_y 39
Map ind 0 0 0 0
found goal
